1111111111111111
1E0000S00000C001
1010010100100001
1010C10000101011
1010100001000001
1S101000010C0001
1C10010100100001
1010010010101C11
1P000000000S0001
1111111111111111