1111111111111111
1E00000000000001
1C10010100100001
1010010010101011
1P00000000000001
1111111111111111